111111111111111111111111111111111111111111111111111111111111111111111111111111111111111111111111111
1PC000000000000000000000000000000000000000000000000000000000000000000000000000000000000000000000001
1CE000000000000000000000000000000000000000000000000000000000000000000000000000000000000000000000001
111111111111111111111111111111111111111111111111111111111111111111111111111111111111111111111111111
