1111111111
1P0CCC0CC1
1C0C0C0C01
1CCC0CCCE1
1111111111
