111111111111
1P01001001E1
100100100101
10010C100101
100100100101
110110101101
100000000001
111111111111
