1111111111111111111111111
1000000000000000000000001
1000000000000000000000001
1000000000001110000000001
1000000000001010000000001
10000P0000001110000000001
1000111111111111111111001
1000101010101010101010001
1000111111111111111111001
1C00000000001110E00000001
1000000000001010000000001
1111111111111111111111111
