111111111111111111111
1PC10CCC000CC01000001
1E1101111111001111111
1C1C010CCCC1001CC1001
1C11100011110011010C1
1000C01000000000011C1
100010001C01111000001
1001C0CC1C01001110111
1001111111110000111C1
10000CCCCCC0000000001
111111111111111111111
