111111111111111111111111111111111111111
1PCCCCC0CCCCC00C00000CCCCC0CC00C0CCCCC1
1EC00000C000C00C00000C000C0C0C0C0C00001
10CCCCC0C000C00C00000C000C0C00CC0C00CC1
100000C0C000C00C00000C000C0C000C0C000C1
10CCCCC0CCCCC00CCCCC0CCCCC0C000C0CCCCC1
111111111111111111111111111111111111111
