11111111111111111111111111111111111111111
1NNNNNNNNNNNNNNNNNNNNNNNNNNNNNNNNNNNNNNN1
1NNNNNNNNNNNNNNNNNNNNNNNNNNNNNNNNNNNNNNN1
1NNNNNNNNNNNNNNNNNNNNNNNNNNNNNNNNNNNNNNN1
1NNNNNNNNNNNNNNNNNNNNNNNNNNNNNNNNNNNNNNN1
1NNNNNNNNNNNNNNNNNPCENNNNNNNNNNNNNNNNNNN1
1NNNNNNNNNNNNNNNNNNNNNNNNNNNNNNNNNNNNNNN1
1NNNNNNNNNNNNNNNNNNNNNNNNNNNNNNNNNNNNNNN1
1NNNNNNNNNNNNNNNNNNNNNNNNNNNNNNNNNNNNNNN1
1NNNNNNNNNNNNNNNNNNNNNNNNNNNNNNNNNNNNNNN1
11111111111111111111111111111111111111111
