1111111111111
1PCCCCCCCCCC1
1CCCCCCCCCCC1
1CCCCCCCCCCC1
1ENCCCCCCCCC1
1111111111111
