1111111111111111111111
100000000NNC00000001C1
10NNNNN100C00000000101
101CCCC10NNN0000000101
101CCCC10NPN0000000NC1
10111011C1E11100000001
1000001NCC00C1000001C1
1111111111111111111111
