111111111
1PN10NNC1
1011CN1C1
1E00CCC01
111111111
